sample_name, l, num_kmers, num_indels, num_insertions, num_deletions, qual_indels, qual_insertions, qual_deletions, KMER_TIME, PROC_TIME, identifier, tumor_num_reads, normal_num_reads, tissue
MSS_13, 5, 121128, 864, 184, 680, 415, 95, 320, 67, 375, MSS, 55486742, 42210516, Colorectal 
MSS_13, 7, 10354, 216, 72, 144, 147, 45, 102, 63, 135, MSS, 55486742, 42210516, Colorectal   
MSS_13, 9, 1605, 37, 12, 25, 32, 11, 21, 77, 106, MSS, 55486742, 42210516, Colorectal   
MSS_13, 11, 526, 3, 0, 3, 3, 0, 3, 74, 113, MSS, 55486742, 42210516, Colorectal  
MSS_13, 13, 187, 2, 0, 2, 2, 0, 2, 72, 104, MSS, 55486742, 42210516, Colorectal  
MSS_10, 5, 58454, 170, 87, 83, 91, 47, 44, 206, 123, MSS, 35945626, 89325132, Endometrial  
MSS_10, 7, 3794, 78, 44, 34, 49, 27, 22, 68, 40, MSS, 35945626, 89325132, Endometrial  
MSS_10, 9, 397, 14, 6, 8, 12, 5, 7, 66, 32, MSS, 35945626, 89325132, Endometrial 
MSS_10, 11, 88, 1, 0, 1, 1, 0, 1, 73, 27, MSS, 35945626, 89325132, Endometrial  
MSS_10, 13, 29, 0, 0, 0, 0, 0, 0, 65, 19, MSS, 35945626, 89325132, Endometrial  
MSS_11, 5, 87845, 497, 185, 312, 260, 101, 159, 209, 184, MSS, 50496004, 46984456, Colorectal  
MSS_11, 7, 7777, 181, 89, 92, 116, 50, 66, 75, 50, MSS, 50496004, 46984456, Colorectal  
MSS_11, 9, 1218, 35, 11, 24, 27, 8, 19, 67, 34, MSS, 50496004, 46984456, Colorectal  
MSS_11, 11, 361, 5, 0, 5, 4, 0, 4, 68, 34, MSS, 50496004, 46984456, Colorectal  
MSS_11, 13, 97, 0, 0, 0, 0, 0, 0, 65, 23, MSS, 50496004, 46984456, Colorectal  
MSS_12, 5, 130316, 993, 173, 820, 476, 98, 378, 203, 379, MSS, 54571318, 47728990, Colorectal  
MSS_12, 7, 9617, 217, 74, 143, 149, 43, 106, 62, 62, MSS, 54571318, 47728990, Colorectal  
MSS_12, 9, 1299, 32, 10, 22, 24, 7, 17, 68, 33, MSS, 54571318, 47728990, Colorectal  
MSS_12, 11, 436, 5, 0, 5, 3, 0, 3, 66, 33, MSS, 54571318, 47728990, Colorectal  
MSS_12, 13, 158, 1, 0, 1, 1, 0, 1, 58, 24, MSS, 54571318, 47728990, Colorectal  
MSS_14, 5, 207072, 1192, 297, 895, 561, 147, 414, 234, 472, MSS, 78198520, 33979281, Colorectal
MSS_14, 7, 18077, 332, 127, 205, 206, 72, 134, 84, 76, MSS, 78198520, 33979281, Colorectal  
MSS_14, 9, 2846, 62, 17, 45, 41, 9, 32, 66, 35, MSS, 78198520, 33979281, Colorectal  
MSS_14, 11, 964, 11, 0, 11, 5, 0, 5, 72, 34, MSS, 78198520, 33979281, Colorectal  
MSS_14, 13, 377, 2, 0, 2, 2, 0, 2, 77, 32, MSS, 78198520, 33979281, Colorectal  
MSS_15, 5, 98607, 704, 149, 555, 337, 76, 261, 212, 281, MSS, 46579187, 53979847, Endometrial  
MSS_15, 7, 7568, 160, 63, 97, 113, 36, 77, 63, 53, MSS, 46579187, 53979847, Endometrial  
MSS_15, 9, 1147, 27, 9, 18, 21, 6, 15, 67, 37, MSS, 46579187, 53979847, Endometrial  
MSS_15, 11, 374, 3, 0, 3, 1, 0, 1, 69, 33, MSS, 46579187, 53979847, Endometrial  
MSS_15, 13, 109, 0, 0, 0, 0, 0, 0, 77, 25, MSS, 46579187, 53979847, Endometrial  
MSS_16, 5, 115738, 877, 172, 705, 413, 88, 325, 243, 333, MSS, 58538320, 75264399, Endometrial
MSS_16, 7, 10012, 186, 68, 118, 118, 36, 82, 70, 63, MSS, 58538320, 75264399, Endometrial  
MSS_16, 9, 1553, 32, 14, 18, 24, 7, 17, 71, 36, MSS, 58538320, 75264399, Endometrial  
MSS_16, 11, 517, 7, 1, 6, 6, 0, 6, 70, 34, MSS, 58538320, 75264399, Endometrial  
MSS_16, 13, 203, 1, 0, 1, 1, 0, 1, 77, 33, MSS, 58538320, 75264399, Endometrial  
MSS_17, 5, 190176, 1501, 323, 1178, 693, 182, 511, 267, 519, MSS, 90899087, 38783336, Endometrial  
MSS_17, 7, 17547, 402, 135, 267, 270, 79, 191, 118, 90, MSS, 90899087, 38783336, Endometrial  
MSS_17, 9, 2829, 60, 12, 48, 49, 8, 41, 85, 43, MSS, 90899087, 38783336, Endometrial  
MSS_17, 11, 955, 11, 0, 11, 8, 0, 8, 81, 41, MSS, 90899087, 38783336, Endometrial  
MSS_17, 13, 352, 4, 0, 4, 3, 0, 3, 82, 40, MSS, 90899087, 38783336, Endometrial  
MSS_18, 5, 88665, 283, 144, 139, 132, 71, 61, 168, 167, MSS, 33518884, 42839488, NA 
MSS_18, 7, 7171, 91, 49, 42, 57, 31, 26, 56, 61, MSS, 33518884, 42839488, NA  
MSS_18, 9, 1210, 22, 5, 17, 14, 3, 11, 67, 50, MSS, 33518884, 42839488, NA  
MSS_18, 11, 400, 9, 1, 8, 4, 0, 4, 57, 50, MSS, 33518884, 42839488, NA  
MSS_18, 13, 126, 2, 0, 2, 0, 0, 0, 57, 43, MSS, 33518884, 42839488, NA  
MSS_19, 5, 88427, 490, 167, 323, 234, 80, 154, 153, 207, MSS, 37131556, 37009029, NA 
MSS_19, 7, 5795, 104, 60, 44, 73, 38, 35, 46, 56, MSS, 37131556, 37009029, NA   
MSS_19, 9, 720, 14, 6, 8, 11, 5, 6, 45, 42, MSS, 37131556, 37009029, NA   
MSS_19, 11, 228, 2, 0, 2, 1, 0, 1, 47, 41, MSS, 37131556, 37009029, NA   
MSS_19, 13, 71, 0, 0, 0, 0, 0, 0, 52, 30, MSS, 37131556, 37009029, NA   
MSS_2, 5, 99205, 452, 174, 278, 236, 103, 133, 190, 227, MSS, 43353048, 40244908, Endometrial  
MSS_2, 7, 8098, 143, 71, 72, 106, 50, 56, 76, 65, MSS, 43353048, 40244908, Endometrial  
MSS_2, 9, 1282, 28, 9, 19, 23, 7, 16, 71, 48, MSS, 43353048, 40244908, Endometrial  
MSS_2, 11, 441, 6, 0, 6, 6, 0, 6, 67, 47, MSS, 43353048, 40244908, Endometrial  
MSS_2, 13, 135, 2, 0, 2, 2, 0, 2, 67, 42, MSS, 43353048, 40244908, Endometrial  
MSS_20, 5, 40161, 111, 60, 51, 58, 32, 26, 130, 82, MSS, 18337860, 41931699, NA  
MSS_20, 7, 3133, 39, 23, 16, 27, 18, 9, 40, 44, MSS, 18337860, 41931699, NA   
MSS_20, 9, 590, 14, 6, 8, 9, 5, 4, 45, 41, MSS, 18337860, 41931699, NA   
MSS_20, 11, 125, 2, 0, 2, 1, 0, 1, 47, 37, MSS, 18337860, 41931699, NA   
MSS_20, 13, 44, 0, 0, 0, 0, 0, 0, 45, 27, MSS, 18337860, 41931699, NA   
MSS_4, 5, 87696, 314, 93, 221, 152, 49, 103, 145, 159, MSS, 31850726, 35279598, Endometrial  
MSS_4, 7, 6831, 116, 48, 68, 80, 31, 49, 53, 46, MSS, 31850726, 35279598, Endometrial  
MSS_4, 9, 1022, 26, 5, 21, 19, 4, 15, 52, 32, MSS, 31850726, 35279598, Endometrial  
MSS_4, 11, 308, 7, 0, 7, 5, 0, 5, 53, 37, MSS, 31850726, 35279598, Endometrial  
MSS_4, 13, 104, 1, 0, 1, 1, 0, 1, 52, 20, MSS, 31850726, 35279598, Endometrial  
MSS_5, 5, 106942, 693, 151, 542, 330, 67, 263, 238, 264, MSS, 59296039, 53111287, Endometrial  
MSS_5, 7, 9473, 191, 70, 121, 125, 30, 95, 74, 59, MSS, 59296039, 53111287, Endometrial  
MSS_5, 9, 1622, 29, 7, 22, 23, 3, 20, 76, 34, MSS, 59296039, 53111287, Endometrial  
MSS_5, 11, 525, 2, 0, 2, 2, 0, 2, 72, 40, MSS, 59296039, 53111287, Endometrial  
MSS_5, 13, 193, 0, 0, 0, 0, 0, 0, 77, 37, MSS, 59296039, 53111287, Endometrial  
MSS_6, 5, 58994, 377, 104, 273, 194, 56, 138, 234, 173, MSS, 43543278, 69192758, Endometrial  
MSS_6, 7, 4225, 88, 44, 44, 60, 26, 34, 81, 60, MSS, 43543278, 69192758, Endometrial   
MSS_6, 9, 627, 15, 3, 12, 12, 2, 10, 78, 49, MSS, 43543278, 69192758, Endometrial   
MSS_6, 11, 181, 1, 0, 1, 0, 0, 0, 77, 52, MSS, 43543278, 69192758, Endometrial   
MSS_6, 13, 57, 1, 0, 1, 0, 0, 0, 84, 42, MSS, 43543278, 69192758, Endometrial   
MSS_7, 5, 113006, 561, 253, 308, 300, 140, 160, 253, 349, MSS, 72371963, 68860669, Endometrial 
MSS_7, 7, 9396, 219, 106, 113, 138, 58, 80, 89, 59, MSS, 72371963, 68860669, Endometrial
MSS_7, 9, 1361, 50, 11, 39, 39, 7, 32, 89, 34, MSS, 72371963, 68860669, Endometrial
MSS_7, 11, 391, 9, 1, 8, 6, 0, 6, 86, 35, MSS, 72371963, 68860669, Endometrial
MSS_7, 13, 140, 2, 0, 2, 1, 0, 1, 91, 28, MSS, 72371963, 68860669, Endometrial
MSS_8, 5, 108676, 631, 194, 437, 317, 113, 204, 245, 259, MSS, 61100241, 58663982, Colorectal
MSS_8, 7, 8060, 168, 85, 83, 109, 50, 59, 90, 60, MSS, 61100241, 58663982, Colorectal
MSS_8, 9, 1236, 29, 10, 19, 20, 6, 14, 85, 33, MSS, 61100241, 58663982, Colorectal
MSS_8, 11, 337, 6, 2, 4, 3, 1, 2, 85, 33, MSS, 61100241, 58663982, Colorectal
MSS_8, 13, 95, 0, 0, 0, 0, 0, 0, 80, 23, MSS, 61100241, 58663982, Colorectal
MSS_1, 5, 66667, 295, 120, 175, 160, 78, 82, 194, 153, MSS, 33737874, 54051795, NA
MSS_1, 7, 5233, 92, 50, 42, 65, 35, 30, 60, 47, MSS, 33737874, 54051795, NA  
MSS_1, 9, 832, 16, 6, 10, 12, 5, 7, 59, 32, MSS, 33737874, 54051795, NA  
MSS_1, 11, 284, 1, 0, 1, 1, 0, 1, 62, 31, MSS, 33737874, 54051795, NA  
MSS_1, 13, 121, 0, 0, 0, 0, 0, 0, 60, 19, MSS, 33737874, 54051795, NA  
MSI_MLH1G_10, 5, 94026, 661, 192, 469, 363, 104, 259, 273, 221, MSI_MLH1G, 67845764, 61509217, Colorectal  
MSI_MLH1G_10, 7, 9542, 246, 77, 169, 186, 46, 140, 86, 57, MSI_MLH1G, 67845764, 61509217, Colorectal
MSI_MLH1G_10, 9, 1975, 72, 7, 65, 65, 4, 61, 85, 36, MSI_MLH1G, 67845764, 61509217, Colorectal
MSI_MLH1G_10, 11, 705, 15, 1, 14, 13, 0, 13, 89, 34, MSI_MLH1G, 67845764, 61509217, Colorectal
MSI_MLH1G_10, 13, 269, 2, 0, 2, 2, 0, 2, 87, 32, MSI_MLH1G, 67845764, 61509217, Colorectal  
MSI_MLH1G_11, 5, 167170, 1359, 260, 1099, 621, 126, 495, 219, 512, MSI_MLH1G, 62886065, 41325532, Endometrial
MSI_MLH1G_11, 7, 13305, 328, 101, 227, 213, 52, 161, 70, 85, MSI_MLH1G, 62886065, 41325532, Endometrial  
MSI_MLH1G_11, 9, 2068, 66, 9, 57, 50, 5, 45, 74, 37, MSI_MLH1G, 62886065, 41325532, Endometrial  
MSI_MLH1G_11, 11, 657, 10, 0, 10, 7, 0, 7, 74, 34, MSI_MLH1G, 62886065, 41325532, Endometrial  
MSI_MLH1G_11, 13, 220, 2, 0, 2, 2, 0, 2, 76, 31, MSI_MLH1G, 62886065, 41325532, Endometrial  
MSI_MLH1G_12, 5, 76163, 498, 126, 372, 253, 55, 198, 223, 202, MSI_MLH1G, 36857017, 66839095, Colorectal 
MSI_MLH1G_12, 7, 6043, 141, 39, 102, 99, 18, 81, 66, 61, MSI_MLH1G, 36857017, 66839095, Colorectal  
MSI_MLH1G_12, 9, 959, 33, 4, 29, 29, 2, 27, 69, 45, MSI_MLH1G, 36857017, 66839095, Colorectal
MSI_MLH1G_12, 11, 316, 5, 0, 5, 3, 0, 3, 68, 45, MSI_MLH1G, 36857017, 66839095, Colorectal    
MSI_MLH1G_12, 13, 91, 1, 0, 1, 1, 0, 1, 67, 27, MSI_MLH1G, 36857017, 66839095, Colorectal    
MSI_MLH1G_13, 5, 100513, 861, 191, 670, 459, 103, 356, 214, 292, MSI_MLH1G, 55475787, 40163543, Colorectal
MSI_MLH1G_13, 7, 8901, 271, 82, 189, 193, 48, 145, 70, 71, MSI_MLH1G, 55475787, 40163543, Colorectal  
MSI_MLH1G_13, 9, 1486, 65, 10, 55, 53, 6, 47, 75, 40, MSI_MLH1G, 55475787, 40163543, Colorectal
MSI_MLH1G_13, 11, 371, 9, 0, 9, 6, 0, 6, 83, 39, MSI_MLH1G, 55475787, 40163543, Colorectal  
MSI_MLH1G_13, 13, 97, 2, 0, 2, 1, 0, 1, 77, 31, MSI_MLH1G, 55475787, 40163543, Colorectal  
MSI_MLH1G_14, 5, 91969, 352, 77, 275, 186, 44, 142, 87, 182, MSI_MLH1G, 13251907, 23954097, Colorectal  
MSI_MLH1G_14, 7, 7022, 109, 33, 76, 83, 24, 59, 32, 52, MSI_MLH1G, 13251907, 23954097, Colorectal 
MSI_MLH1G_14, 9, 1408, 28, 2, 26, 23, 1, 22, 34, 34, MSI_MLH1G, 13251907, 23954097, Colorectal
MSI_MLH1G_14, 11, 553, 4, 0, 4, 2, 0, 2, 33, 31, MSI_MLH1G, 13251907, 23954097, Colorectal    
MSI_MLH1G_14, 13, 223, 0, 0, 0, 0, 0, 0, 31, 22, MSI_MLH1G, 13251907, 23954097, Colorectal    
MSI_MLH1G_15, 5, 123328, 970, 205, 765, 475, 93, 382, 250, 334, MSI_MLH1G, 74051643, 43939570, Colorectal
MSI_MLH1G_15, 7, 12593, 292, 88, 204, 184, 40, 144, 87, 68, MSI_MLH1G, 74051643, 43939570, Colorectal  
MSI_MLH1G_15, 9, 2254, 57, 11, 46, 43, 5, 38, 78, 37, MSI_MLH1G, 74051643, 43939570, Colorectal  
MSI_MLH1G_15, 11, 817, 12, 1, 11, 5, 0, 5, 83, 33, MSI_MLH1G, 74051643, 43939570, Colorectal  
MSI_MLH1G_15, 13, 278, 1, 0, 1, 1, 0, 1, 74, 33, MSI_MLH1G, 74051643, 43939570, Colorectal  
MSI_MLH1G_2, 5, 76888, 530, 84, 446, 277, 47, 230, 242, 214, MSI_MLH1G, 41661734, 84074744, Ovarian 
MSI_MLH1G_2, 7, 5372, 120, 31, 89, 93, 22, 71, 79, 46, MSI_MLH1G, 41661734, 84074744, Ovarian 
MSI_MLH1G_2, 9, 761, 26, 6, 20, 23, 4, 19, 78, 33, MSI_MLH1G, 41661734, 84074744, Ovarian
MSI_MLH1G_2, 11, 211, 3, 0, 3, 3, 0, 3, 73, 31, MSI_MLH1G, 41661734, 84074744, Ovarian 
MSI_MLH1G_2, 13, 67, 1, 0, 1, 1, 0, 1, 70, 23, MSI_MLH1G, 41661734, 84074744, Ovarian 
MSI_MLH1G_3, 5, 119196, 784, 158, 626, 406, 88, 318, 211, 276, MSI_MLH1G, 61558548, 35792918, Colorectal  
MSI_MLH1G_3, 7, 11104, 263, 75, 188, 184, 47, 137, 65, 61, MSI_MLH1G, 61558548, 35792918, Colorectal
MSI_MLH1G_3, 9, 1950, 59, 7, 52, 45, 6, 39, 70, 36, MSI_MLH1G, 61558548, 35792918, Colorectal
MSI_MLH1G_3, 11, 645, 13, 0, 13, 7, 0, 7, 65, 35, MSI_MLH1G, 61558548, 35792918, Colorectal
MSI_MLH1G_3, 13, 213, 4, 0, 4, 3, 0, 3, 68, 31, MSI_MLH1G, 61558548, 35792918, Colorectal
MSI_MLH1G_4, 5, 213037, 1109, 193, 916, 531, 95, 436, 168, 460, MSI_MLH1G, 45136562, 34768567, Colorectal
MSI_MLH1G_4, 7, 16658, 282, 84, 198, 203, 48, 155, 54, 70, MSI_MLH1G, 45136562, 34768567, Colorectal
MSI_MLH1G_4, 9, 2463, 57, 7, 50, 43, 4, 39, 53, 36, MSI_MLH1G, 45136562, 34768567, Colorectal
MSI_MLH1G_4, 11, 796, 14, 0, 14, 10, 0, 10, 53, 34, MSI_MLH1G, 45136562, 34768567, Colorectal
MSI_MLH1G_4, 13, 279, 3, 0, 3, 2, 0, 2, 60, 28, MSI_MLH1G, 45136562, 34768567, Colorectal
MSI_MLH1G_6, 5, 36885, 77, 19, 58, 51, 12, 39, 126, 66, MSI_MLH1G, 13983794, 39437183, NA
MSI_MLH1G_6, 7, 3396, 46, 9, 37, 35, 7, 28, 38, 37, MSI_MLH1G, 13983794, 39437183, NA
MSI_MLH1G_6, 9, 793, 18, 1, 17, 15, 1, 14, 43, 32, MSI_MLH1G, 13983794, 39437183, NA
MSI_MLH1G_6, 11, 339, 7, 0, 7, 5, 0, 5, 43, 31, MSI_MLH1G, 13983794, 39437183, NA
MSI_MLH1G_6, 13, 142, 1, 0, 1, 1, 0, 1, 41, 13, MSI_MLH1G, 13983794, 39437183, NA
MSI_MLH1G_7, 5, 100702, 652, 161, 491, 360, 93, 267, 225, 238, MSI_MLH1G, 55837803, 49704994, Colorectal
MSI_MLH1G_7, 7, 10545, 252, 66, 186, 181, 42, 139, 68, 71, MSI_MLH1G, 55837803, 49704994, Colorectal 
MSI_MLH1G_7, 9, 2110, 76, 10, 66, 63, 4, 59, 69, 45, MSI_MLH1G, 55837803, 49704994, Colorectal
MSI_MLH1G_7, 11, 638, 13, 0, 13, 11, 0, 11, 73, 39, MSI_MLH1G, 55837803, 49704994, Colorectal 
MSI_MLH1G_7, 13, 228, 1, 0, 1, 1, 0, 1, 72, 33, MSI_MLH1G, 55837803, 49704994, Colorectal
MSI_MLH1G_8, 5, 222370, 812, 265, 547, 440, 145, 295, 191, 365, MSI_MLH1G, 64599028, 21370488, Colorectal
MSI_MLH1G_8, 7, 18499, 334, 131, 203, 222, 79, 143, 61, 74, MSI_MLH1G, 64599028, 21370488, Colorectal
MSI_MLH1G_8, 9, 3273, 83, 16, 67, 64, 11, 53, 62, 37, MSI_MLH1G, 64599028, 21370488, Colorectal
MSI_MLH1G_8, 11, 1041, 17, 1, 16, 10, 0, 10, 67, 33, MSI_MLH1G, 64599028, 21370488, Colorectal
MSI_MLH1G_8, 13, 355, 1, 0, 1, 0, 0, 0, 62, 31, MSI_MLH1G, 64599028, 21370488, Colorectal
MSI_MLH1HM_1, 5, 73240, 340, 66, 274, 160, 33, 127, 150, 173, MSI_MLH1G, 28371610, 35712033, Endometrial
MSI_MLH1HM_1, 7, 5513, 112, 34, 78, 63, 16, 47, 58, 49, MSI_MLH1G, 28371610, 35712033, Endometrial
MSI_MLH1HM_1, 9, 781, 24, 4, 20, 13, 1, 12, 52, 37, MSI_MLH1G, 28371610, 35712033, Endometrial
MSI_MLH1HM_1, 11, 210, 6, 1, 5, 2, 0, 2, 53, 37, MSI_MLH1G, 28371610, 35712033, Endometrial
MSI_MLH1HM_1, 13, 62, 1, 0, 1, 0, 0, 0, 56, 29, MSI_MLH1G, 28371610, 35712033, Endometrial
MSI_MLH1HM_10, 5, 140837, 1605, 287, 1318, 737, 141, 596, 279, 501, MSI_MLH1HM, 76432837, 67438814, Endometrial
MSI_MLH1HM_10, 7, 12971, 328, 104, 224, 228, 60, 168, 99, 72, MSI_MLH1HM, 76432837, 67438814, Endometrial
MSI_MLH1HM_10, 9, 1971, 59, 12, 47, 46, 7, 39, 100, 34, MSI_MLH1HM, 76432837, 67438814, Endometrial
MSI_MLH1HM_10, 11, 551, 13, 0, 13, 8, 0, 8, 96, 34, MSI_MLH1HM, 76432837, 67438814, Endometrial
MSI_MLH1HM_10, 13, 151, 2, 0, 2, 1, 0, 1, 97, 28, MSI_MLH1HM, 76432837, 67438814, Endometrial 
MSI_MLH1HM_11, 5, 78482, 860, 154, 706, 438, 86, 352, 195, 302, MSI_MLH1HM, 44333852, 47565665, Colorectal
MSI_MLH1HM_11, 7, 7481, 236, 81, 155, 168, 50, 118, 61, 63, MSI_MLH1HM, 44333852, 47565665, Colorectal
MSI_MLH1HM_11, 9, 1217, 38, 4, 34, 31, 4, 27, 61, 37, MSI_MLH1HM, 44333852, 47565665, Colorectal 
MSI_MLH1HM_11, 11, 421, 10, 0, 10, 5, 0, 5, 63, 35, MSI_MLH1HM, 44333852, 47565665, Colorectal 
MSI_MLH1HM_11, 13, 122, 2, 0, 2, 1, 0, 1, 62, 27, MSI_MLH1HM, 44333852, 47565665, Colorectal 
MSI_MLH1HM_12, 5, 104553, 702, 151, 551, 352, 75, 277, 178, 300, MSI_MLH1HM, 42379503, 36686072, Colorectal
MSI_MLH1HM_12, 7, 8855, 218, 72, 146, 151, 43, 108, 61, 64, MSI_MLH1HM, 42379503, 36686072, Colorectal
MSI_MLH1HM_12, 9, 1540, 56, 9, 47, 45, 8, 37, 55, 37, MSI_MLH1HM, 42379503, 36686072, Colorectal
MSI_MLH1HM_12, 11, 401, 11, 0, 11, 7, 0, 7, 54, 32, MSI_MLH1HM, 42379503, 36686072, Colorectal
MSI_MLH1HM_12, 13, 120, 1, 0, 1, 1, 0, 1, 57, 31, MSI_MLH1HM, 42379503, 36686072, Colorectal
MSI_MLH1HM_13, 5, 161775, 1187, 270, 917, 616, 145, 471, 315, 381, MSI_MLH1HM, 92530631, 46921869, Colorectal
MSI_MLH1HM_13, 7, 14873, 353, 102, 251, 252, 61, 191, 105, 65, MSI_MLH1HM, 92530631, 46921869, Colorectal
MSI_MLH1HM_13, 9, 2416, 76, 12, 64, 64, 8, 56, 111, 37, MSI_MLH1HM, 92530631, 46921869, Colorectal
MSI_MLH1HM_13, 11, 780, 15, 0, 15, 13, 0, 13, 108, 32, MSI_MLH1HM, 92530631, 46921869, Colorectal
MSI_MLH1HM_13, 13, 275, 1, 0, 1, 1, 0, 1, 105, 32, MSI_MLH1HM, 92530631, 46921869, Colorectal
MSI_MLH1HM_15, 5, 230698, 1035, 244, 791, 506, 123, 383, 191, 429, MSI_MLH1HM, 64737321, 23357105, Colorectal
MSI_MLH1HM_15, 7, 18967, 308, 96, 212, 206, 54, 152, 64, 72, MSI_MLH1HM, 64737321, 23357105, Colorectal
MSI_MLH1HM_15, 9, 3000, 72, 7, 65, 52, 5, 47, 58, 37, MSI_MLH1HM, 64737321, 23357105, Colorectal
MSI_MLH1HM_15, 11, 968, 17, 0, 17, 11, 0, 11, 60, 33, MSI_MLH1HM, 64737321, 23357105, Colorectal
MSI_MLH1HM_15, 13, 349, 4, 0, 4, 3, 0, 3, 52, 31, MSI_MLH1HM, 64737321, 23357105, Colorectal
MSI_MLH1HM_16, 5, 127450, 1004, 267, 737, 518, 135, 383, 263, 337, MSI_MLH1HM, 63374598, 58974315, NA
MSI_MLH1HM_16, 7, 12165, 286, 87, 199, 202, 55, 147, 76, 60, MSI_MLH1HM, 63374598, 58974315, NA
MSI_MLH1HM_16, 9, 2412, 77, 10, 67, 59, 8, 51, 89, 36, MSI_MLH1HM, 63374598, 58974315, NA
MSI_MLH1HM_16, 11, 870, 19, 0, 19, 13, 0, 13, 83, 33, MSI_MLH1HM, 63374598, 58974315, NA
MSI_MLH1HM_16, 13, 319, 2, 0, 2, 2, 0, 2, 74, 37, MSI_MLH1HM, 63374598, 58974315, NA
MSI_MLH1HM_17, 5, 77811, 288, 100, 188, 180, 58, 122, 141, 149, MSI_MLH1HM, 30355314, 33235077, NA
MSI_MLH1HM_17, 7, 6487, 142, 41, 101, 110, 31, 79, 51, 45, MSI_MLH1HM, 30355314, 33235077, NA
MSI_MLH1HM_17, 9, 1245, 51, 5, 46, 42, 4, 38, 52, 35, MSI_MLH1HM, 30355314, 33235077, NA
MSI_MLH1HM_17, 11, 399, 10, 0, 10, 7, 0, 7, 53, 31, MSI_MLH1HM, 30355314, 33235077, NA
MSI_MLH1HM_17, 13, 151, 0, 0, 0, 0, 0, 0, 48, 13, MSI_MLH1HM, 30355314, 33235077, NA
MSI_MLH1HM_18, 5, 201846, 483, 160, 323, 259, 84, 175, 213, 320, MSI_MLH1HM, 58784292, 37784009, NA
MSI_MLH1HM_18, 7, 15320, 231, 76, 155, 153, 44, 109, 81, 79, MSI_MLH1HM, 58784292, 37784009, NA  
MSI_MLH1HM_18, 9, 2384, 59, 7, 52, 44, 3, 41, 69, 48, MSI_MLH1HM, 58784292, 37784009, NA 
MSI_MLH1HM_18, 11, 754, 12, 0, 12, 8, 0, 8, 74, 43, MSI_MLH1HM, 58784292, 37784009, NA 
MSI_MLH1HM_18, 13, 297, 2, 0, 2, 2, 0, 2, 83, 28, MSI_MLH1HM, 58784292, 37784009, NA
MSI_MLH1HM_19, 5, 93036, 356, 99, 257, 175, 51, 124, 171, 175, MSI_MLH1HM, 25454534, 48864669, NA
MSI_MLH1HM_19, 7, 7069, 85, 24, 61, 58, 14, 44, 67, 45, MSI_MLH1HM, 25454534, 48864669, NA
MSI_MLH1HM_19, 9, 1294, 22, 2, 20, 17, 2, 15, 51, 36, MSI_MLH1HM, 25454534, 48864669, NA
MSI_MLH1HM_19, 11, 528, 4, 0, 4, 2, 0, 2, 53, 34, MSI_MLH1HM, 25454534, 48864669, NA
MSI_MLH1HM_19, 13, 223, 0, 0, 0, 0, 0, 0, 64, 15, MSI_MLH1HM, 25454534, 48864669, NA
MSI_MLH1HM_2, 5, 81840, 523, 144, 379, 280, 93, 187, 207, 204, MSI_MLH1HM, 43843750, 46678308, Endometrial
MSI_MLH1HM_2, 7, 6754, 143, 54, 89, 100, 35, 65, 80, 58, MSI_MLH1HM, 43843750, 46678308, Endometrial
MSI_MLH1HM_2, 9, 1134, 30, 9, 21, 22, 5, 17, 74, 35, MSI_MLH1HM, 43843750, 46678308, Endometrial
MSI_MLH1HM_2, 11, 328, 8, 1, 7, 4, 0, 4, 76, 32, MSI_MLH1HM, 43843750, 46678308, Endometrial
MSI_MLH1HM_2, 13, 102, 1, 0, 1, 1, 0, 1, 67, 24, MSI_MLH1HM, 43843750, 46678308, Endometrial
MSI_MLH1HM_20, 5, 119001, 556, 179, 377, 316, 93, 223, 239, 220, MSI_MLH1HM, 60540467, 54258346, NA
MSI_MLH1HM_20, 7, 10710, 215, 66, 149, 154, 36, 118, 75, 60, MSI_MLH1HM, 60540467, 54258346, NA
MSI_MLH1HM_20, 9, 2019, 49, 7, 42, 42, 4, 38, 71, 36, MSI_MLH1HM, 60540467, 54258346, NA
MSI_MLH1HM_20, 11, 718, 9, 0, 9, 7, 0, 7, 77, 38, MSI_MLH1HM, 60540467, 54258346, NA
MSI_MLH1HM_20, 13, 274, 1, 0, 1, 1, 0, 1, 77, 31, MSI_MLH1HM, 60540467, 54258346, NA
MSI_MLH1HM_3, 5, 112850, 632, 155, 477, 326, 85, 241, 210, 253, MSI_MLH1HM, 53818728, 40999291, Endometrial
MSI_MLH1HM_3, 7, 9274, 181, 62, 119, 124, 36, 88, 69, 51, MSI_MLH1HM, 53818728, 40999291, Endometrial
MSI_MLH1HM_3, 9, 1620, 37, 5, 32, 24, 2, 22, 68, 40, MSI_MLH1HM, 53818728, 40999291, Endometrial
MSI_MLH1HM_3, 11, 557, 12, 1, 11, 4, 0, 4, 71, 40, MSI_MLH1HM, 53818728, 40999291, Endometrial
MSI_MLH1HM_3, 13, 198, 3, 0, 3, 2, 0, 2, 71, 31, MSI_MLH1HM, 53818728, 40999291, Endometrial
MSI_MLH1HM_4, 5, 40906, 267, 85, 182, 130, 49, 81, 234, 105, MSI_MLH1HM, 25290748, 77197168, Endometrial
MSI_MLH1HM_4, 7, 3459, 98, 41, 57, 69, 30, 39, 61, 40, MSI_MLH1HM, 25290748, 77197168, Endometrial
MSI_MLH1HM_4, 9, 636, 32, 5, 27, 23, 4, 19, 61, 34, MSI_MLH1HM, 25290748, 77197168, Endometrial
MSI_MLH1HM_4, 11, 156, 7, 0, 7, 2, 0, 2, 63, 34, MSI_MLH1HM, 25290748, 77197168, Endometrial
MSI_MLH1HM_4, 13, 35, 1, 0, 1, 0, 0, 0, 62, 16, MSI_MLH1HM, 25290748, 77197168, Endometrial
MSI_MLH1HM_5, 5, 159381, 924, 252, 672, 479, 137, 342, 216, 352, MSI_MLH1HM, 63673117, 43238922, Endometrial
MSI_MLH1HM_5, 7, 14570, 280, 101, 179, 197, 66, 131, 72, 71, MSI_MLH1HM, 63673117, 43238922, Endometrial
MSI_MLH1HM_5, 9, 2607, 63, 13, 50, 46, 8, 38, 70, 33, MSI_MLH1HM, 63673117, 43238922, Endometrial 
MSI_MLH1HM_5, 11, 952, 17, 0, 17, 10, 0, 10, 78, 33, MSI_MLH1HM, 63673117, 43238922, Endometrial
MSI_MLH1HM_5, 13, 347, 2, 0, 2, 1, 0, 1, 73, 34, MSI_MLH1HM, 63673117, 43238922, Endometrial
MSI_MLH1HM_6, 5, 47944, 277, 70, 207, 161, 41, 120, 225, 129, MSI_MLH1HM, 33384792, 83671325, Endometrial
MSI_MLH1HM_6, 7, 3907, 109, 36, 73, 81, 25, 56, 83, 64, MSI_MLH1HM, 33384792, 83671325, Endometrial
MSI_MLH1HM_6, 9, 607, 27, 3, 24, 18, 2, 16, 67, 44, MSI_MLH1HM, 33384792, 83671325, Endometrial
MSI_MLH1HM_6, 11, 146, 8, 0, 8, 4, 0, 4, 74, 42, MSI_MLH1HM, 33384792, 83671325, Endometrial
MSI_MLH1HM_6, 13, 35, 1, 0, 1, 0, 0, 0, 71, 31, MSI_MLH1HM, 33384792, 83671325, Endometrial
MSI_MLH1HM_7, 5, 55261, 416, 80, 336, 228, 43, 185, 206, 169, MSI_MLH1HM, 34450602, 63760925, Endometrial
MSI_MLH1HM_7, 7, 4953, 129, 35, 94, 92, 21, 71, 62, 45, MSI_MLH1HM, 34450602, 63760925, Endometrial
MSI_MLH1HM_7, 9, 808, 26, 2, 24, 21, 1, 20, 64, 34, MSI_MLH1HM, 34450602, 63760925, Endometrial 
MSI_MLH1HM_7, 11, 240, 7, 0, 7, 6, 0, 6, 60, 36, MSI_MLH1HM, 34450602, 63760925, Endometrial
MSI_MLH1HM_7, 13, 112, 2, 0, 2, 2, 0, 2, 72, 21, MSI_MLH1HM, 34450602, 63760925, Endometrial
MSI_MLH1HM_8, 5, 117699, 1084, 223, 861, 539, 123, 416, 239, 348, MSI_MLH1HM, 60115955, 55236262, Endometrial
MSI_MLH1HM_8, 7, 10869, 258, 83, 175, 178, 51, 127, 83, 72, MSI_MLH1HM, 60115955, 55236262, Endometrial
MSI_MLH1HM_8, 9, 1765, 40, 9, 31, 32, 7, 25, 91, 50, MSI_MLH1HM, 60115955, 55236262, Endometrial 
MSI_MLH1HM_8, 11, 627, 8, 0, 8, 5, 0, 5, 89, 49, MSI_MLH1HM, 60115955, 55236262, Endometrial
MSI_MLH1HM_8, 13, 234, 3, 0, 3, 2, 0, 2, 82, 47, MSI_MLH1HM, 60115955, 55236262, Endometrial
MSI_MLH1HM_9, 5, 579734, 398, 66, 332, 104, 16, 88, 209, 989, MSI_MLH1HM, 95559672, 88231954, Endometrial
MSI_MLH1HM_9, 7, 37732, 215, 53, 162, 66, 16, 50, 66, 96, MSI_MLH1HM, 95559672, 88231954, Endometrial
MSI_MLH1HM_9, 9, 4894, 59, 9, 50, 36, 3, 33, 78, 39, MSI_MLH1HM, 95559672, 88231954, Endometrial
MSI_MLH1HM_9, 11, 1495, 10, 0, 10, 7, 0, 7, 70, 36, MSI_MLH1HM, 95559672, 88231954, Endometrial
MSI_MLH1HM_9, 13, 551, 3, 0, 3, 2, 0, 2, 73, 37, MSI_MLH1HM, 95559672, 88231954, Endometrial
MSI_MSH2_1, 5, 76651, 690, 124, 566, 324, 63, 261, 266, 256, MSI_MSH2, 53495411, 65399131, Colorectal
MSI_MSH2_1, 7, 7654, 201, 54, 147, 140, 35, 105, 84, 71, MSI_MSH2, 53495411, 65399131, Colorectal
MSI_MSH2_1, 9, 1245, 46, 4, 42, 35, 2, 33, 83, 52, MSI_MSH2, 53495411, 65399131, Colorectal
MSI_MSH2_1, 11, 363, 10, 0, 10, 5, 0, 5, 94, 49, MSI_MSH2, 53495411, 65399131, Colorectal
MSI_MSH2_1, 13, 91, 1, 0, 1, 0, 0, 0, 84, 41, MSI_MSH2, 53495411, 65399131, Colorectal 
MSI_MSH2_10, 5, 110962, 971, 176, 795, 470, 97, 373, 217, 328, MSI_MSH2, 54631846, 45418068, Colorectal
MSI_MSH2_10, 7, 9173, 271, 75, 196, 186, 45, 141, 60, 75, MSI_MSH2, 54631846, 45418068, Colorectal 
MSI_MSH2_10, 9, 1357, 51, 7, 44, 46, 7, 39, 60, 49, MSI_MSH2, 54631846, 45418068, Colorectal 
MSI_MSH2_10, 11, 418, 8, 0, 8, 8, 0, 8, 60, 48, MSI_MSH2, 54631846, 45418068, Colorectal 
MSI_MSH2_10, 13, 119, 2, 0, 2, 2, 0, 2, 61, 44, MSI_MSH2, 54631846, 45418068, Colorectal 
MSI_MSH2_11, 5, 142062, 1045, 223, 822, 536, 128, 408, 237, 391, MSI_MSH2, 55387807, 58351625, NA
MSI_MSH2_11, 7, 11942, 320, 85, 235, 229, 54, 175, 71, 83, MSI_MSH2, 55387807, 58351625, NA
MSI_MSH2_11, 9, 1869, 78, 13, 65, 64, 12, 52, 72, 36, MSI_MSH2, 55387807, 58351625, NA 
MSI_MSH2_11, 11, 498, 15, 0, 15, 8, 0, 8, 80, 33, MSI_MSH2, 55387807, 58351625, NA 
MSI_MSH2_11, 13, 110, 1, 0, 1, 0, 0, 0, 71, 31, MSI_MSH2, 55387807, 58351625, NA 
MSI_MSH2_12, 5, 108097, 985, 205, 780, 472, 106, 366, 233, 347, MSI_MSH2, 55627108, 55704395, Endometrial
MSI_MSH2_12, 7, 10097, 270, 87, 183, 189, 49, 140, 71, 66, MSI_MSH2, 55627108, 55704395, Endometrial
MSI_MSH2_12, 9, 1862, 62, 8, 54, 53, 4, 49, 73, 38, MSI_MSH2, 55627108, 55704395, Endometrial 
MSI_MSH2_12, 11, 586, 13, 0, 13, 11, 0, 11, 71, 36, MSI_MSH2, 55627108, 55704395, Endometrial 
MSI_MSH2_12, 13, 200, 2, 0, 2, 1, 0, 1, 70, 33, MSI_MSH2, 55627108, 55704395, Endometrial
MSI_MSH2_2, 5, 146166, 887, 202, 685, 446, 112, 334, 174, 341, MSI_MSH2, 51299636, 33081004, Colorectal
MSI_MSH2_2, 7, 12914, 259, 76, 183, 179, 44, 135, 64, 74, MSI_MSH2, 51299636, 33081004, Colorectal
MSI_MSH2_2, 9, 2286, 61, 7, 54, 47, 4, 43, 58, 42, MSI_MSH2, 51299636, 33081004, Colorectal 
MSI_MSH2_2, 11, 708, 13, 0, 13, 9, 0, 9, 68, 40, MSI_MSH2, 51299636, 33081004, Colorectal
MSI_MSH2_2, 13, 246, 3, 0, 3, 1, 0, 1, 61, 34, MSI_MSH2, 51299636, 33081004, Colorectal
MSI_MSH2_4, 5, 157501, 1244, 210, 1034, 605, 107, 498, 177, 433, MSI_MSH2, 52043789, 31091823, Colorectal
MSI_MSH2_4, 7, 12339, 307, 87, 220, 212, 46, 166, 53, 73, MSI_MSH2, 52043789, 31091823, Colorectal
MSI_MSH2_4, 9, 1983, 63, 8, 55, 54, 5, 49, 56, 37, MSI_MSH2, 52043789, 31091823, Colorectal
MSI_MSH2_4, 11, 520, 8, 0, 8, 6, 0, 6, 56, 40, MSI_MSH2, 52043789, 31091823, Colorectal
MSI_MSH2_4, 13, 136, 1, 0, 1, 1, 0, 1, 55, 33, MSI_MSH2, 52043789, 31091823, Colorectal
MSI_MSH2_5, 5, 2878, 7, 0, 7, 6, 0, 6, 188, 36, MSI_MSH2, 3432959, 93100071, Colorectal
MSI_MSH2_5, 7, 260, 7, 0, 7, 6, 0, 6, 52, 34, MSI_MSH2, 3432959, 93100071, Colorectal
MSI_MSH2_5, 9, 80, 3, 0, 3, 3, 0, 3, 57, 26, MSI_MSH2, 3432959, 93100071, Colorectal
MSI_MSH2_5, 11, 20, 1, 0, 1, 1, 0, 1, 61, 20, MSI_MSH2, 3432959, 93100071, Colorectal
MSI_MSH2_5, 13, 10, 0, 0, 0, 0, 0, 0, 60, 17, MSI_MSH2, 3432959, 93100071, Colorectal
MSI_MSH2_6, 5, 173006, 808, 184, 624, 388, 98, 290, 169, 379, MSI_MSH2, 42199872, 21816192, Colorectal
MSI_MSH2_6, 7, 12478, 215, 76, 139, 151, 48, 103, 57, 61, MSI_MSH2, 42199872, 21816192, Colorectal
MSI_MSH2_6, 9, 1946, 46, 11, 35, 36, 9, 27, 56, 38, MSI_MSH2, 42199872, 21816192, Colorectal 
MSI_MSH2_6, 11, 668, 6, 0, 6, 4, 0, 4, 54, 35, MSI_MSH2, 42199872, 21816192, Colorectal 
MSI_MSH2_6, 13, 278, 2, 0, 2, 2, 0, 2, 53, 27, MSI_MSH2, 42199872, 21816192, Colorectal 
MSI_MSH2_7, 5, 99775, 293, 65, 228, 152, 33, 119, 132, 171, MSI_MSH2, 22351033, 22685383, Colorectal
MSI_MSH2_7, 7, 5607, 71, 30, 41, 53, 19, 34, 38, 42, MSI_MSH2, 22351033, 22685383, Colorectal
MSI_MSH2_7, 9, 862, 16, 4, 12, 15, 4, 11, 35, 34, MSI_MSH2, 22351033, 22685383, Colorectal
MSI_MSH2_7, 11, 228, 2, 1, 1, 2, 1, 1, 35, 29, MSI_MSH2, 22351033, 22685383, Colorectal
MSI_MSH2_7, 13, 71, 0, 0, 0, 0, 0, 0, 37, 30, MSI_MSH2, 22351033, 22685383, Colorectal
MSI_MSH2_9, 5, 267632, 926, 178, 748, 434, 80, 354, 205, 455, MSI_MSH2, 55279613, 15194412, Colorectal
MSI_MSH2_9, 7, 18758, 297, 87, 210, 183, 41, 142, 53, 71, MSI_MSH2, 55279613, 15194412, Colorectal 
MSI_MSH2_9, 9, 3015, 61, 8, 53, 45, 5, 40, 51, 38, MSI_MSH2, 55279613, 15194412, Colorectal 
MSI_MSH2_9, 11, 1007, 12, 0, 12, 9, 0, 9, 56, 35, MSI_MSH2, 55279613, 15194412, Colorectal 
MSI_MSH2_9, 13, 407, 5, 0, 5, 3, 0, 3, 50, 32, MSI_MSH2, 55279613, 15194412, Colorectal 
MSI_MSH6_1, 5, 54253, 383, 62, 321, 188, 25, 163, 213, 164, MSI_MSH6, 36290112, 58652298, Endometrial
MSI_MSH6_1, 7, 4330, 107, 28, 79, 67, 13, 54, 82, 50, MSI_MSH6, 36290112, 58652298, Endometrial
MSI_MSH6_1, 9, 704, 27, 2, 25, 21, 1, 20, 65, 38, MSI_MSH6, 36290112, 58652298, Endometrial  
MSI_MSH6_1, 11, 201, 6, 0, 6, 4, 0, 4, 64, 34, MSI_MSH6, 36290112, 58652298, Endometrial 
MSI_MSH6_1, 13, 53, 2, 0, 2, 1, 0, 1, 65, 19, MSI_MSH6, 36290112, 58652298, Endometrial 
MSI_MSH6_10, 5, 105128, 748, 139, 609, 356, 72, 284, 194, 293, MSI_MSH6, 43567409, 49488495, Endometrial
MSI_MSH6_10, 7, 7513, 201, 62, 139, 136, 31, 105, 61, 55, MSI_MSH6, 43567409, 49488495, Endometrial
MSI_MSH6_10, 9, 1068, 44, 8, 36, 36, 4, 32, 57, 36, MSI_MSH6, 43567409, 49488495, Endometrial
MSI_MSH6_10, 11, 297, 8, 0, 8, 8, 0, 8, 60, 35, MSI_MSH6, 43567409, 49488495, Endometrial
MSI_MSH6_10, 13, 94, 2, 0, 2, 2, 0, 2, 65, 26, MSI_MSH6, 43567409, 49488495, Endometrial
MSI_MSH6_11, 5, 87841, 914, 204, 710, 448, 107, 341, 295, 329, MSI_MSH6, 65673848, 74556715, Endometrial
MSI_MSH6_11, 7, 7547, 224, 64, 160, 151, 41, 110, 83, 71, MSI_MSH6, 65673848, 74556715, Endometrial 
MSI_MSH6_11, 9, 1109, 40, 9, 31, 32, 8, 24, 85, 49, MSI_MSH6, 65673848, 74556715, Endometrial  
MSI_MSH6_11, 11, 315, 7, 0, 7, 4, 0, 4, 93, 47, MSI_MSH6, 65673848, 74556715, Endometrial
MSI_MSH6_11, 13, 79, 1, 0, 1, 1, 0, 1, 96, 44, MSI_MSH6, 65673848, 74556715, Endometrial
MSI_MSH6_12, 5, 208852, 295, 50, 245, 145, 26, 119, 162, 293, MSI_MSH6, 30079947, 118281039, Colorectal
MSI_MSH6_12, 7, 12161, 128, 31, 97, 81, 20, 61, 50, 59, MSI_MSH6, 30079947, 118281039, Colorectal
MSI_MSH6_12, 9, 1511, 37, 7, 30, 27, 4, 23, 49, 41, MSI_MSH6, 30079947, 118281039, Colorectal
MSI_MSH6_12, 11, 382, 6, 0, 6, 4, 0, 4, 54, 37, MSI_MSH6, 30079947, 118281039, Colorectal
MSI_MSH6_12, 13, 110, 2, 0, 2, 1, 0, 1, 52, 34, MSI_MSH6, 30079947, 118281039, Colorectal
MSI_MSH6_2, 5, 214661, 1508, 320, 1188, 705, 158, 547, 280, 532, MSI_MSH6, 97939634, 36412965, Endometrial
MSI_MSH6_2, 7, 19047, 391, 130, 261, 252, 60, 192, 114, 97, MSI_MSH6, 97939634, 36412965, Endometrial
MSI_MSH6_2, 9, 3235, 75, 17, 58, 55, 10, 45, 101, 50, MSI_MSH6, 97939634, 36412965, Endometrial
MSI_MSH6_2, 11, 1140, 15, 0, 15, 8, 0, 8, 108, 47, MSI_MSH6, 97939634, 36412965, Endometrial
MSI_MSH6_2, 13, 458, 5, 0, 5, 3, 0, 3, 98, 45, MSI_MSH6, 97939634, 36412965, Endometrial
MSI_MSH6_3, 5, 75570, 316, 62, 254, 166, 34, 132, 141, 159, MSI_MSH6, 23781120, 41403851, Endometrial
MSI_MSH6_3, 7, 5790, 97, 32, 65, 68, 19, 49, 51, 53, MSI_MSH6, 23781120, 41403851, Endometrial
MSI_MSH6_3, 9, 881, 18, 5, 13, 16, 5, 11, 50, 42, MSI_MSH6, 23781120, 41403851, Endometrial 
MSI_MSH6_3, 11, 306, 3, 0, 3, 2, 0, 2, 51, 43, MSI_MSH6, 23781120, 41403851, Endometrial
MSI_MSH6_3, 13, 121, 3, 0, 3, 2, 0, 2, 63, 36, MSI_MSH6, 23781120, 41403851, Endometrial
MSI_MSH6_4, 5, 41003, 205, 48, 157, 110, 27, 83, 175, 130, MSI_MSH6, 27722059, 46375511, Endometrial
MSI_MSH6_4, 7, 2760, 55, 20, 35, 38, 14, 24, 64, 58, MSI_MSH6, 27722059, 46375511, Endometrial
MSI_MSH6_4, 9, 404, 12, 4, 8, 11, 4, 7, 62, 59, MSI_MSH6, 27722059, 46375511, Endometrial
MSI_MSH6_4, 11, 119, 4, 0, 4, 3, 0, 3, 74, 47, MSI_MSH6, 27722059, 46375511, Endometrial
MSI_MSH6_4, 13, 27, 2, 0, 2, 2, 0, 2, 62, 31, MSI_MSH6, 27722059, 46375511, Endometrial
MSI_PMS2_1, 5, 50817, 214, 60, 154, 106, 29, 77, 152, 127, MSI_PMS2, 25011621, 39671724, Colorectal
MSI_PMS2_1, 7, 3392, 64, 27, 37, 39, 15, 24, 56, 49, MSI_PMS2, 25011621, 39671724, Colorectal
MSI_PMS2_1, 9, 569, 16, 4, 12, 10, 3, 7, 55, 41, MSI_PMS2, 25011621, 39671724, Colorectal
MSI_PMS2_1, 11, 157, 2, 0, 2, 1, 0, 1, 56, 42, MSI_PMS2, 25011621, 39671724, Colorectal
MSI_PMS2_1, 13, 35, 0, 0, 0, 0, 0, 0, 54, 22, MSI_PMS2, 25011621, 39671724, Colorectal 
MSI_PMS2_10, 5, 125943, 1148, 312, 836, 589, 171, 418, 232, 427, MSI_PMS2, 68598012, 36698811, Colorectal
MSI_PMS2_10, 7, 10564, 301, 117, 184, 226, 79, 147, 70, 82, MSI_PMS2, 68598012, 36698811, Colorectal
MSI_PMS2_10, 9, 1606, 58, 12, 46, 51, 9, 42, 66, 44, MSI_PMS2, 68598012, 36698811, Colorectal
MSI_PMS2_10, 11, 412, 11, 1, 10, 8, 0, 8, 76, 41, MSI_PMS2, 68598012, 36698811, Colorectal
MSI_PMS2_10, 13, 125, 3, 0, 3, 2, 0, 2, 70, 30, MSI_PMS2, 68598012, 36698811, Colorectal
MSI_PMS2_11, 5, 97696, 815, 136, 679, 360, 69, 291, 195, 290, MSI_PMS2, 40813421, 47369098, Endometrial
MSI_PMS2_11, 7, 8392, 198, 61, 137, 122, 32, 90, 63, 54, MSI_PMS2, 40813421, 47369098, Endometrial 
MSI_PMS2_11, 9, 1408, 38, 6, 32, 29, 5, 24, 60, 39, MSI_PMS2, 40813421, 47369098, Endometrial
MSI_PMS2_11, 11, 470, 9, 0, 9, 7, 0, 7, 63, 38, MSI_PMS2, 40813421, 47369098, Endometrial
MSI_PMS2_11, 13, 128, 3, 0, 3, 2, 0, 2, 65, 34, MSI_PMS2, 40813421, 47369098, Endometrial
MSI_PMS2_13, 5, 71030, 653, 110, 543, 289, 49, 240, 188, 271, MSI_PMS2, 41601500, 44352691, Colorectal
MSI_PMS2_13, 7, 5009, 112, 37, 75, 77, 22, 55, 67, 56, MSI_PMS2, 41601500, 44352691, Colorectal
MSI_PMS2_13, 9, 753, 13, 4, 9, 10, 3, 7, 57, 41, MSI_PMS2, 41601500, 44352691, Colorectal
MSI_PMS2_13, 11, 230, 2, 0, 2, 1, 0, 1, 53, 39, MSI_PMS2, 41601500, 44352691, Colorectal
MSI_PMS2_13, 13, 82, 0, 0, 0, 0, 0, 0, 54, 33, MSI_PMS2, 41601500, 44352691, Colorectal
MSI_PMS2_14, 5, 124378, 890, 211, 679, 478, 129, 349, 175, 329, MSI_PMS2, 56566155, 30326202, Colorectal
MSI_PMS2_14, 7, 9700, 231, 84, 147, 173, 54, 119, 58, 70, MSI_PMS2, 56566155, 30326202, Colorectal
MSI_PMS2_14, 9, 1498, 45, 9, 36, 40, 8, 32, 52, 44, MSI_PMS2, 56566155, 30326202, Colorectal
MSI_PMS2_14, 11, 491, 7, 0, 7, 5, 0, 5, 52, 43, MSI_PMS2, 56566155, 30326202, Colorectal
MSI_PMS2_14, 13, 189, 2, 0, 2, 2, 0, 2, 59, 44, MSI_PMS2, 56566155, 30326202, Colorectal
MSI_PMS2_15, 5, 116484, 1107, 290, 817, 572, 160, 412, 299, 359, MSI_PMS2, 80844661, 63814990, Colorectal
MSI_PMS2_15, 7, 11487, 316, 125, 191, 214, 72, 142, 92, 80, MSI_PMS2, 80844661, 63814990, Colorectal
MSI_PMS2_15, 9, 1934, 55, 15, 40, 40, 8, 32, 114, 50, MSI_PMS2, 80844661, 63814990, Colorectal
MSI_PMS2_15, 11, 622, 10, 1, 9, 6, 0, 6, 93, 50, MSI_PMS2, 80844661, 63814990, Colorectal
MSI_PMS2_15, 13, 199, 1, 0, 1, 1, 0, 1, 116, 47, MSI_PMS2, 80844661, 63814990, Colorectal
MSI_PMS2_16, 5, 316437, 348, 105, 243, 185, 58, 127, 202, 397, MSI_PMS2, 56241076, 103468219, Colorectal
MSI_PMS2_16, 7, 20049, 188, 59, 129, 117, 35, 82, 80, 78, MSI_PMS2, 56241076, 103468219, Colorectal
MSI_PMS2_16, 9, 2574, 62, 6, 56, 49, 5, 44, 72, 39, MSI_PMS2, 56241076, 103468219, Colorectal
MSI_PMS2_16, 11, 735, 18, 0, 18, 14, 0, 14, 70, 37, MSI_PMS2, 56241076, 103468219, Colorectal
MSI_PMS2_16, 13, 181, 4, 0, 4, 3, 0, 3, 66, 33, MSI_PMS2, 56241076, 103468219, Colorectal
MSI_PMS2_2, 5, 102092, 327, 103, 224, 186, 55, 131, 143, 186, MSI_PMS2, 28952565, 33816191, Endometrial
MSI_PMS2_2, 7, 6670, 121, 52, 69, 84, 32, 52, 52, 48, MSI_PMS2, 28952565, 33816191, Endometrial
MSI_PMS2_2, 9, 835, 27, 5, 22, 19, 4, 15, 58, 34, MSI_PMS2, 28952565, 33816191, Endometrial
MSI_PMS2_2, 11, 186, 6, 0, 6, 2, 0, 2, 53, 33, MSI_PMS2, 28952565, 33816191, Endometrial
MSI_PMS2_2, 13, 35, 1, 0, 1, 0, 0, 0, 58, 18, MSI_PMS2, 28952565, 33816191, Endometrial
MSI_PMS2_3, 5, 83928, 449, 125, 324, 248, 65, 183, 182, 198, MSI_PMS2, 36951394, 46884475, Colorectal
MSI_PMS2_3, 7, 8060, 174, 49, 125, 125, 33, 92, 69, 62, MSI_PMS2, 36951394, 46884475, Colorectal
MSI_PMS2_3, 9, 1649, 43, 6, 37, 34, 5, 29, 61, 47, MSI_PMS2, 36951394, 46884475, Colorectal
MSI_PMS2_3, 11, 601, 12, 0, 12, 8, 0, 8, 69, 46, MSI_PMS2, 36951394, 46884475, Colorectal
MSI_PMS2_3, 13, 222, 2, 0, 2, 1, 0, 1, 64, 34, MSI_PMS2, 36951394, 46884475, Colorectal
MSI_PMS2_4, 5, 103812, 877, 158, 719, 407, 88, 319, 219, 301, MSI_PMS2, 43572578, 58010743, Colorectal
MSI_PMS2_4, 7, 7744, 173, 65, 108, 127, 49, 78, 72, 56, MSI_PMS2, 43572578, 58010743, Colorectal
MSI_PMS2_4, 9, 1053, 28, 9, 19, 22, 7, 15, 70, 38, MSI_PMS2, 43572578, 58010743, Colorectal
MSI_PMS2_4, 11, 289, 4, 0, 4, 2, 0, 2, 66, 38, MSI_PMS2, 43572578, 58010743, Colorectal
MSI_PMS2_4, 13, 85, 1, 0, 1, 0, 0, 0, 64, 30, MSI_PMS2, 43572578, 58010743, Colorectal
MSI_PMS2_5, 5, 163038, 1084, 202, 882, 482, 101, 381, 196, 426, MSI_PMS2, 58567978, 34470683, Colorectal
MSI_PMS2_5, 7, 12680, 226, 77, 149, 148, 48, 100, 69, 60, MSI_PMS2, 58567978, 34470683, Colorectal
MSI_PMS2_5, 9, 1962, 38, 8, 30, 29, 5, 24, 59, 36, MSI_PMS2, 58567978, 34470683, Colorectal
MSI_PMS2_5, 11, 689, 6, 0, 6, 6, 0, 6, 63, 33, MSI_PMS2, 58567978, 34470683, Colorectal
MSI_PMS2_5, 13, 234, 3, 0, 3, 3, 0, 3, 65, 30, MSI_PMS2, 58567978, 34470683, Colorectal
MSI_PMS2_6, 5, 70033, 710, 202, 508, 333, 104, 229, 238, 232, MSI_PMS2, 39135949, 90004779, Colorectal
MSI_PMS2_6, 7, 6119, 176, 77, 99, 126, 53, 73, 68, 47, MSI_PMS2, 39135949, 90004779, Colorectal
MSI_PMS2_6, 9, 868, 25, 7, 18, 23, 7, 16, 75, 34, MSI_PMS2, 39135949, 90004779, Colorectal
MSI_PMS2_6, 11, 164, 1, 0, 1, 1, 0, 1, 69, 32, MSI_PMS2, 39135949, 90004779, Colorectal
MSI_PMS2_6, 13, 28, 0, 0, 0, 0, 0, 0, 66, 15, MSI_PMS2, 39135949, 90004779, Colorectal
MSI_PMS2_7, 5, 160366, 1168, 259, 909, 558, 131, 427, 198, 416, MSI_PMS2, 61728345, 31382809, Colorectal
MSI_PMS2_7, 7, 14418, 326, 114, 212, 214, 63, 151, 60, 86, MSI_PMS2, 61728345, 31382809, Colorectal
MSI_PMS2_7, 9, 2439, 66, 15, 51, 49, 10, 39, 65, 47, MSI_PMS2, 61728345, 31382809, Colorectal
MSI_PMS2_7, 11, 884, 16, 0, 16, 9, 0, 9, 66, 45, MSI_PMS2, 61728345, 31382809, Colorectal
MSI_PMS2_7, 13, 333, 2, 0, 2, 1, 0, 1, 62, 42, MSI_PMS2, 61728345, 31382809, Colorectal
MSI_MSH6_6, 5, 79609, 406, 179, 227, 213, 88, 125, 265, 248, MSI_MSH6, 61185821, 78122340, Endometrial
MSI_MSH6_6, 7, 6333, 144, 65, 79, 92, 37, 55, 79, 57, MSI_MSH6, 61185821, 78122340, Endometrial
MSI_MSH6_6, 9, 912, 33, 9, 24, 24, 5, 19, 83, 34, MSI_MSH6, 61185821, 78122340, Endometrial
MSI_MSH6_6, 11, 198, 5, 0, 5, 3, 0, 3, 78, 36, MSI_MSH6, 61185821, 78122340, Endometrial
MSI_MSH6_6, 13, 92, 1, 0, 1, 1, 0, 1, 89, 26, MSI_MSH6, 61185821, 78122340, Endometrial
MSI_MSH6_7, 5, 63645, 632, 121, 511, 307, 69, 238, 218, 225, MSI_MSH6, 33252330, 63013192, Endometrial
MSI_MSH6_7, 7, 6177, 138, 43, 95, 96, 26, 70, 58, 58, MSI_MSH6, 33252330, 63013192, Endometrial
MSI_MSH6_7, 9, 1197, 24, 4, 20, 17, 1, 16, 59, 46, MSI_MSH6, 33252330, 63013192, Endometrial
MSI_MSH6_7, 11, 449, 5, 1, 4, 3, 1, 2, 60, 46, MSI_MSH6, 33252330, 63013192, Endometrial
MSI_MSH6_7, 13, 207, 2, 0, 2, 1, 0, 1, 59, 46, MSI_MSH6, 33252330, 63013192, Endometrial
MSI_MSH6_8, 5, 83549, 1040, 176, 864, 509, 84, 425, 186, 338, MSI_MSH6, 46951280, 40958946, Endometrial
MSI_MSH6_8, 7, 7722, 246, 77, 169, 172, 41, 131, 62, 67, MSI_MSH6, 46951280, 40958946, Endometrial
MSI_MSH6_8, 9, 1226, 40, 7, 33, 32, 3, 29, 64, 40, MSI_MSH6, 46951280, 40958946, Endometrial
MSI_MSH6_8, 11, 364, 6, 0, 6, 4, 0, 4, 65, 39, MSI_MSH6, 46951280, 40958946, Endometrial
MSI_MSH6_8, 13, 109, 1, 0, 1, 1, 0, 1, 64, 32, MSI_MSH6, 46951280, 40958946, Endometrial
MSI_PMS2_9, 5, 75760, 629, 139, 490, 295, 76, 219, 229, 276, MSI_PMS2, 41430771, 62757465, Endometrial
MSI_PMS2_9, 7, 6386, 159, 58, 101, 98, 33, 65, 74, 73, MSI_PMS2, 41430771, 62757465, Endometrial
MSI_PMS2_9, 9, 898, 25, 7, 18, 17, 3, 14, 72, 48, MSI_PMS2, 41430771, 62757465, Endometrial
MSI_PMS2_9, 11, 243, 1, 0, 1, 0, 0, 0, 83, 46, MSI_PMS2, 41430771, 62757465, Endometrial
MSI_PMS2_9, 13, 51, 0, 0, 0, 0, 0, 0, 72, 38, MSI_PMS2, 41430771, 62757465, Endometrial
